**********
*P       *
*        *
*        *
*   **   *
*    M   *
*        *
***      *
*      *G*
**********