******************
*P               *
*                *
*                *
*   **           *
*                *
*                *
***              *
*      *G*       *
******************